#####11#####
#__________#
#_k______k_#
#__________#
#__________#
#_k______k_#
#__________#
#__________#
############

// rune:1 display:_ map:map2 location:4
