######################
#____________________#
#____________________#
#____________________#
#____________________#
#____________________#
#____________________#
#____________________#
#____________________#
#____________________#
#____________________#
#____________________#
#____________________#
#____________________#
#____________________#
#____________________#
#____________________#
###########1##########

// rune:1 display:_ map:map2 location:1
